10 10
##########
#.s#.x.$$#
#..#...###
#$##x$..x#
#.....#.x#
##.###..$#
#$.$#..###
#.x.#.#.$#
#.$.#...2#
##########