15 10
###############
#...x...xx....#
#3x...x....#$$#
#########..####
#$$##.s##x.$$$#
#$$##x.######.#
#$x....#......#
#$#.x###.xx##.#
#$#......##$$.#
###############