15 5
###############
#.......$...x$#
#..######.x####
#s.#4.$$....x$#
###############