10 11
##########
#5.......#
######x.x#
#.$$..x..#
#x..x..$$#
#..#######
#..x.$$.x#
#x....x..#
#######..#
#s.....$$#
##########