20 15
####################
#s...............$$#
#################..#
#f$$#x$$$x##.......#
###$#$$x$$$#...#####
#$$$####$x$#.$...#.#
#.###$$#xx.$..x....#
#...#$$$#########..#
#xx.#x.x#....$$$#..#
#...#.....x.#####..#
#x..$..x....#$$$...#
#########...#####..#
#$$$x...#...#####..#
#$$$..x............#
####################